1111
1001
1001
1001
1001
1111
1111