11111111
10000001
111000W1
10000101
10001011
10000001
10001011
11111111
