
       EA ./textures/north.png


SO ./textures/S.png


WE ./textures/W.png



NO          ./textures/N.png


               
F 120,0,1
C 120,89,255
        1111111111111111111111111
        1N000000000000000000000001
        10100110011110000000000001
        10010110100000000000000001
1111111110110110011110000000000001
100000000000000000000000000000011
111111111000000000000000000001111
      10000000000000000000011
      10000000000000000000011
      10000000000000000000011
1111111110000000000000000000011
100000000000000000000000000000011
100000000000000000000000000000011111111
 111000000001111111100100111111000000011
   10000000011  11100100111111000000011
 111000000001111100100111111000000011
10000000000000000000000000000001111
1000000000000000000000011111111
1000000000000000000000011
1000000000000000000000011
100000000000000000000001111111
1111011111111110111000000100001
11111111111 1111111111111111111
