EA ./textures/E.png
SO ./textures/S.png
WE ./textures/W.png
NO ./textures/N.png
F  120,   89,0
C  10,30,12


111111111111111111111111111111
100010001000100010001000100011
1N1000100010001000100010001001
111111111111111111111111111111