EA ./textures/E.png

SO ./textures/S.png

    WE ./textures/W.png

NO ./textures/N.png

C 120,89,255
F 120,0,1


        11111111111111111111111111                      
        10000000000000000000000001
        10100110011110000000000001
        10010110100000000000000001
1111111110110110011110000000000001
100000000000000000000000000000011
100000000000000000000000000000011
100000000000000000000000000000011
100000000000000000000000000000011
100000000000000000000000000000011
100000000000000000000000000000011
100000000000000000000000000000011
100000000000000000000000000000011
1000000001111100100111111000000011
1000000001111100100111111000000011
1000000001111100100111111000000011
100000000000000000000000000000011
100000000000000000000000000000011
100000000000000000000000000000011
100000000000000000000000000000011
100000000000000000000000000000011
1111011111111110111000000100001
11111111111 1111111101111111101
                   101      1N1
                   101      101
                   101      101
                   101      101
                   101      101
                   101      101
                   101      101
1111111111111111111101      101
1000000000000000000001      101
1011111111111111111101      101
1000000000000000000001      101
1111111111111111111111      101
                            101
                            101
                            101
                            101
                            101
                            101
                            101
            111111111111111110111
            111111111111111110111
            1000000000000000000001
            1000000000000000000001
            1000000000000000000001
            111111111111111111111
