11111111
10000011
10010111
11001001
10001011
10100001
10110101
11111111