
 EA ./textures/E.png


SO ./textures/S.png

WE ./textures/W.png

NO ./textures/N.png


F 120,0,1
C 120,89,0





        11111111111111111111111111                       
        1N0000000000000000000000001
        10100110011110000000000001
        10010110100000000000000001
1111111110110110011110000000000001
100000000000000000000000000000011
1111011111111110111000000100011
11111111111 1111111111111111111



