EA ./textures/E.png
SO ./textures/S.png
WE ./textures/W.png
NO ./textures/N.png


F 120,89,0
C 11,120,21

1111111111111
100110N0110111111
11111111111

10