   EA     ./path_to_the_east_texture          

     SO       ./RACHIdA	                              
WE ./path_to_the_west_texture  
NO     ./AYAC          
F  120,   89,0
C  10,30,12


111111111
1000000001
1000000001
1000000001
1000000001
1000000001
1000000001
1000000001
1000000011111
100000001110S111
10000000011100001
1111000011111111
    1000011
1111000001
1000000011
11111111