EA ./textures/E.png
SO ./textures/S.png
WE ./textures/W.png
NO ./textures/N.png


F 120,89,0
C 11,120,25

        1111111N11111111111111111
        100000000110000000000001
        1011000001110000000000001
        1001000000000000000000001
111111111011000001110000000000001
100000000011000001110111111111111
111101111111110111000000100011
111101111111110111010100100011
110000001101010111000000100011
10000000000000001100000010001
10000000000000001101010010001
1100000111010101111101111000111
11110111 1110101 101111010001
11111111 1111111 11111111111