EA ./textures/E.png

SO ./textures/S.png

    WE ./textures/W.png

NO ./textures/N.png

C 120,89,255
F 120,0,1



1111111111111111111111
10000000000000000000N1
1011111111111111111101
1000000000000000000001
1111111111111111111111